TCTTTTTTTTTTTTTTTTTTTTTTTTTTTTTTTTTTTTTTTTTTTTTTTTTTTTTTTTTTTTTTTT
T.....A.TTTTTTTTTTTTTTTTTTTTTTTTTTTTTTTTTTTTTTTTT...............TT
T.............................TTTTTTTTTTTTTTTTTTT...............TT
T.M..L..TTTTTTTT...TTTTTTTTT.TTTTTTT.TTTTTTTT4TTTTTT.TTTTTTT.TTTTT
TTTTTTT.TTTTTTT4.TTTTTTTTTTT.TTTTTTT.TTTTTT.T.....TT.TTTTTTT.TTTTT
TTT........TTTTT....TTTT.....TTTTTTT.TTTTTT...TTT....TT......TTTTT
TTT.......TTTTTTTTT......TTTTT.......TTTTTTT..TTTTTTTTT.TTTT.TTTTT
TTT....T...TTTTTTTTTTTTT3TTTTT.TTTTTTTTTTTTT.TTTT.......TTTT.TTTTT
TTT.TTT.T......................TTTTTTTTTTTTT.TTTT.TTTTTTTTTT.TTTTT
TTT...T.T.T.......T............TTTTTTTTT........................TT
TTT...T.T.TTTTTTT.T.TTT........TTTTTTTTTT2TTTTTTTT.TTTTTTTTTT.TTTT
T.....T.T.........T...T............................TTTTTTTTTT.TTTT
T.....T.T.T.TTTTTTTTT.TTTTTTTT.TTTTTT.TTTTTTTTTT.TTTTTTT......TTTT
T.....T...T...TTT.....T....A...TTTTTT.TTTTTTTT...TTTTTTT.TTTT.TTTT
T.T.T.TTTTTTT.TTT.TTT.T........TTTTTT.TTTTTTTT.TTTTTTTTT.TTTT.TTTT
T...T...T.......T.TTT.T........TTTTTT.TT........................TT
TTTTT.T.T.TTT.T.T.TTT.T........TTTT...TT........................TT
T.....T...T...T.T.T...T........TTTT.TATT........................TT
T...TTTTTTT.TTT.T.T.TTT.............................M...........TT
T...TTT...T...T...T.TTT........TTTTT.TT.TTTTTTT.TTTTTTTTTTT.TTTTTT
TTT.TTT.T.TTT.TTTTT.TTT........TTTTT.TT.TTTTTTT.TTTTTT......TTTTTT
T...T...T.T.....T...TTT........TTTTT.TT.TTTTTTT.TTTTTT.TTTT....TTT
T...T.T.T.T.TTT.T.T.TTT....TTTTTTTTT...................TTTT.TT.TTT
T....T.T...TTT...T..........ATTTTTTTTTTTT.TTTTTTTTTTTTTTTT.TTTTTT
T.TTTTT.TTTTTTTT.TTTTLT....TTTTTTTTTTTTT........................TT
TLTTTTT1TTTTTTTT.TTTTTT.........................................TT
TTTT.............TTTTTTT.TTTTTTTTTTTTTTTTTTTTTTTTTTTTT5.........TT
TTTT.............TTTTTAT.TTTTTTTTTTTTTTTTTTTTTTTTTTTTT..........TT
TTTT.....................TTTTTTTTTTTTTTTTTTTTTTTTTTTTT..........TT
TTTTTTTTTTTTTTTTTTTTTTTTTTTTTTTTTTTTTTTTTTTTTTTTTTTTTTTTTTTTTTTTTT
