TCTTTTTTTTTTTTTTTTTTTTTTTTTTTTTTTTTTTTTTTTTTTTTTTTTTTTTTTTTTTTTTTTTTTTTTTTTTTTTTTTTTTTTTTTTTTTTTTTTTTTTTTTTTTTTTTTTTTT
T..1............................................................TT....................................................
T.....A.TTTTTTTTTTTTTTTTTTTTTTTTTTTTTTTT........................TT....................................................
T.M..L..TTTTTTTTTTTTTTTTTTTTTTTTTTTTTTTT........................TT....................................................
TTTTTTT.TTTTTTT4TTTTTTTTTTTTTTTTTTTTTTTT........................TT....................................................
TTT........TTTTTTTTTTTTTTTTTTTTTTTTTTTTT........................TT....................................................
TTT.......TTTTTTTTTTTTTTTTTTTTTTTTTTTTT.........................TT...................................................
TTT....T...TTTTTTTTTTTTTTTTTTTTTTTTTTTTT........................TT....................................................
TTT.TTT.T......................TTTTTTTTT........................TT....................................................
TTT...T.T.T.......T............TTTTTTTTT........................TT....................................................
TTT...T.T.TTTTTTT.T.TTT........TTTTTTTTT........................TT....................................................
T.....T.T.........T...T........TTTTTTTTT........................TT....................................................
T.....T.T.T.TTTTTTTTT.T........TTTTTTTTT........................TT....................................................
T.....T...T...TTT.....T....A...TTTTTTTTT........................TT....................................................
T.T.T.TTTTTTT.TTT.TTT.T........TTTTTTTTT........................TT....................................................
T...T...T.......T.TTT.T...rrr..TTTTTTTTT........................TT....................................................
TTTTT.T.T.TTT.T.T.TTT.T...WWW..TTTTTTTTT........................TT....................................................
T.....T...T...T.T.T...T...WWW..TTTTTTATT........................TT....................................................
T...TTTTTTT.TTT.T.T.TTT...WWW..TTTTTTTTT............M...........TT....................................................
T...TTT...T...T...T.TTT...WWW..TTTTTTTTT4.......................TT....................................................
TTT.TTT.T.TTT.TTTTT.TTT...WWW..TTTTTTTTT........................TT....................................................
T...T...T.T.....T...TTT........TTTTTTTTT........................TT....................................................
T...T.TTT.T.TTT.T.T.TTT....TTTTTTTTTTTTT........................TT....................................................
T.....TTT...TTT...T..........ATTTTTTTTTT........................TT....................................................
T.TTTTTTTTTTTTTTTTTTTLT....TTTTTTTTTTTTT........................TT....................................................
TLTTTTTTTTTTTTTTTTTTTTT....TTTTTTTTTTTTTTTTTTTTTTTTTTT..........TT....................................................
TTTTTTTMTTTTTTTTTTTTTTTTTTTTTTTTTTTTTTTTTTTTTTTTTTTTTT..........TT....................................................
TTTTTTTTTTTTTTTTTTTTTTATTTTTTTTTTTTTTTTTTTTTTTTTTTTTTT..........TT....................................................
TTTTTTTTTTTTTTTTTTTTTTTTTTTTTTTTTTTTTTTTTTTTTTTTTTTTTT..........TT....................................................
...TTT...T...T...T.TTT...WWW..TTTTTTTTT.........................TT...................................................
TTT.TTT.T.TTT.TTTTT.TTT...WWW..TTTTTTTTT........................TT....................................................
T...T...T.T.....T...TTT........TTTTTTTTT........................TT....................................................
T...T.TTT.T.TTT.T.T.TTT....TTTTTTTTTTTTT........................TT....................................................
T.....TTT.M.TTT...T..........ATTTTTTTTTT........................TT....................................................
T.TTTTTTTTTTTTTTTTTTTLT....TTTTTTTTTTTTT........................TT....................................................
TLTTTTTTTTTTATTTTTTTTTT....TTTTTTTTTTTTTTTTTTTTTTTTTTT..........TT....................................................
TTTTTTTTTTTTTTTTTTTTTTTTTTTTTTTTTTTTTTTTTTTTTTTTTTTTTT..........TT....................................................
TTTTTTTTTTTTTTTTTTTTTTTTTTTTTTTTTTTTTTTTTTTTTTTTTTTTTM..........TT....................................................
TTTTTTTTTTTTTTTTTTTTTTTTTTTTTTTTTTTTTTTTTTTTTTTTTTTTTT..........TT.......................................................TTT...T...T...T.TTT...WWW..TTTTTTTTT..............................................................................
TTT.TTT.T.TTT.TTTTT.TTT...WWW..TTTTTTTTT........................TT....................................................
T...T...T.T.....T...TTT........TTTTTTTTT........................TT....................................................
T...T.TTT.T.TTT.T.T.TTT....TTTTTTTTTTTTT........................TT....................................................
T.....TTTA..TTT...T..........ATTTTTTTTTT........................TT....................................................
T.TTTTTTTTTTTTTTTTTTTLTM...TTTTTTTTTTTTT........................TT....................................................
TLTTTTTTTTTTTTTTTTTTTTT....TTTTTTTTTTTTTTTTTTTTTTTTTTT..........TT....................................................
TTTTTTTTTTTTTTTTTTTTTTTTTTTTTTTTTTTTTTTTTTTTTTTTTTTTTT..........TT....................................................
TTTTTTTTTTTATTTTTTTTTTTTTTTTTTTTTTTTTTTTTTTTTTTTTTTTTT..........TT....................................................
TTTTTTTTTTTTTTTTTTTTTTTTTTTTTTTTTTTTTTTTTTTTTTTTTTTTTT..........TT.......................................................TTT...T...T...T.TTT...WWW..TTTTTTTTT..............................................................................
TTT.TTT.T.TTT.TTTTT.TTT...WWW..TTTTTTTTT........................TT....................................................
T...T...T.T.....T...TTT........TTTTTTTTT........................TT....................................................
T...T.TTT.T.TTT.T.T.TTT....TTTTTTTTTTTTT........................TT....................................................
T.....TTT.A.TTT...T..........ATTTTTTTTTT........................TT....................................................
T.TTTTTTTTTTTTTTTTTTTLT....TTTTTTTTTTTTT........................TT....................................................
TLTTTTTTTTTTTTTTTTTTTTT....TTTTTTTTTTTTTTTTTTTTTTTTTTT..........TT....................................................
TTTTTTTTTTTTTTTTTTTTTTTTTTTTTTTTTTTTTTTTTTTTTTTTTTTTTT..........TT....................................................
TTTTTTTTTTTTTTTTTTTTTTTTTTTTTTTTTTTTTTTTTTTTTTTTTTTTTT..........TT....................................................
TTTTTTTTTTTTTTTTTTTTTTTTTTTTTTTTTTTTTTTTTTTTTTTTTTTTTT..........TT....................................................