TCTTTTTTTTTTTTTTTTTTTTTTTTTTTTTTTTTTTTTTTTTTTTTTTTTTTTTTTTTTTTTTTT
T.....A.TTTTTTTTTTTTTTTTTTTTTTTTTTTTTTTTTTTTTTTTT...............TT
T.............................TTTTTTTTTTTTTTTTTTT...............TT
T.M..L..TTTTTTTT...TTTTTTTTT.TTTTTTT.TTTTTTTT.TTTTTT.TTTTTTT.TTTTT
TTTTTTT.TTTTTTT4.TTTTTTTTTTT.TTTTTTT.TTTTTT.T.....TT.TTTTTTT.TTTTT
TTT........TTTTT....TTTT.....TTTTTTT.TTTTTT...TTT....TT......TTTTT
TTT.......TTTTTTTTT......TTTTT.......TTTTTTT..TTTTTTTTT.TTTT.TTTTT
TTT....T...TTTTTTTTTTTTT.TTTTT.TTTTTTTTTTTTT.TTTT.......TTTT.TTTTT
TTT.TTT.T......................TTTTTTTTTTTTT.TTTT.TTTTTTTTTT.TTTTT
TTT...T.T.T.......T............TTTTTTTTT........................TT
TTT...T.T.TTTTTTT.T.TTT........TTTTTTTTTT.TTTTTTTT.TTTTTTTTTT.TTTT
T.....T.T.........T...T............................TTTTTTTTTT.TTTT
T.....T.T.T.TTTTTTTTT.TTTTTTTT.TTTTTT.TTTTTTTTTT.TTTTTTT......TTTT
T.....T...T...TTT.....T....A...TTTTTT.TTTTTTTT...TTTTTTT.TTTT.TTTT
T.T.T.TTTTTTT.TTT.TTT.T........TTTTTT.TTTTTTTT.TTTTTTTTT.TTTT.TTTT
T...T...T.......T.TTT.T...rrr..TTTTTT.TT........................TT
TTTTT.T.T.TTT.T.T.TTT.T...WWW..TTTT...TT........................TT
T.....T...T...T.T.T...T...WWW..TTTT.TATT........................TT
T...TTTTTTT.TTT.T.T.TTT...WWW.......................M...........TT
T...TTT...T...T...T.TTT...WWW..TTTTT.TT.TTTTTTT.TTTTTTTTTTT.TTTTTT
TTT.TTT.T.TTT.TTTTT.TTT...WWW..TTTTT.TT.TTTTTTT.TTTTTT......TTTTTT
T...T...T.T.....T...TTT........TTTTT.TT.TTTTTTT.TTTTTT.TTTT....TTT
T...T.T.T.T.TTT.T.T.TTT....TTTTTTTTT...................TTTT.TT.TTT
T.....T.T...TTT...T..........ATTTTTTTTTTTT.TTTTTTTTTTTTTTTT.TTTTTT
T.TTTTT.TTTTTTTT.TTTTLT....TTTTTTTTTTTTT........................TT
TLTTTTT.TTTTTTTT.TTTTTT.........................................TT
TTTT.............TTTTTTT.TTTTTTTTTTTTTTTTTTTTTTTTTTTTT..........TT
TTTT.............TTTTTAT.TTTTTTTTTTTTTTTTTTTTTTTTTTTTT..........TT
TTTT.....................TTTTTTTTTTTTTTTTTTTTTTTTTTTTT..........TT
TTTTTTTTTTTTTTTTTTTTTTTTTTTTTTTTTTTTTTTTTTTTTTTTTTTTTTTTTTTTTTTTTT
