TCTTTTTTTTTTTTTTTTTTTTTTTTTTTTTTTTTTTTTTTTTTTTTTTTTTTTTTTTTTTTTTTT
T.......TTTTTTTTTTTTTTTTTTTTTTTTTTTTTTTTTTTTTTT9T..............3TT
T.......TTTTTTTTTTTTTTTTTTTTTLTTTTTTTTTTTTTTTTTTT...............TT
T....L..TTTTTTTTTTTTTTTTTTT.TTTTTTT.TTTTTTTTTTTTTTT.TTTTTTT.TTTTTT
TTTTTTT.TTTTTTT4TTTTTTTTTTTT.TTTTTTT.TTTTTTTT.....TT.TTTTTTT.TTTTT
TTT.A......TTTTTTTTTTTTT.....TTTTTTT.TTTTTT...TTT....TT......TTT9T
TTT.......TTTTTTTTT......TTTTT.......TTTTTTT..TTTTTTTTT.TTTT.TTTTT
TTT....T...TTTTTTTTTTTTT.TTTTT.TTTTTTTTTTTTT.TTTT.......TTTT.TTTTT
TTT.TTT.T.....T................TTTTTTTTTTTTT.TTTT.TTTTTTTTTT.TTTTT
TTT...T.T.T.......T............TTTTTTTTT........................TT
TTT...T.T.TTTTTTT.T.TTT........TTTTTTTTTT2TTTTTTTT.TTTTTTTTTT.TTTT
T9....T.T.........T...T............................TTTTTTTTTT.TTTT
T.....T.T.T.TTTTTTTTT.TTTTTTTT.TTTTTT.TTTTTTTTTT.TTTTTTTA.....TTTT
TL....T...T...TTT.....T....A...TTTTTT.TTTTTTTT...TTTTTTT.TTTT.TTTT
T.T.T.TTTTTTT.TTT.TTT.T........TTTTTT.TTTTTTTT.TTTTTTTTT.TTTT.TTTT
T...T...T.......T.TTT.T........TTTTTT.TT.........L..............TT
TTTTT.T.T.TTT.T.T.TTT.T........TTTT...TT........................TT
T.....T...T...T.T.T...TL.......TTTT.TATT........................TT
T...TTTTTTT.TTT.T.T.TTT.........................................TT
T...TTT.A.T...T...T.TTT........TTTTT.TT.TTTTTTT.TTTTTTTTTTT.TTTTTT
TTT.TTT.T.TTT.TTTTT.TTT........TTTTT.TT.TTTTTTT.TTTTTT......TTTTTT
T...T...T.T.....T...TTT........TTTTT.TT.TTTTTTT.TTTTTT.TTTT....TTT
T...T.T.T.T.TTTTT.T.TTT....TTTTTTTTT...................TTTT.TT.TTT
T...AT.T...TTT...T..........ATTTTTTTTTTTT.TTTTTTTTTTTTTTTT.TTTTTTT
T.TTTTT.TTTTTTTT.TTTTLT....TTTTTTTTTTTTT..T......L.........TT...TT
TLTTTTTTTTTTTTTT.TTTTTT......................T...........T...T..TT
TTTT.............TTTTTTT.TTTTTTTTTTTTTTTTTTTTTTTTTTTTTT......T.5TT
TTTT.............9TTTTAT.TTTTTTTTTTTTTTTTTTTTTTTTTTTTT.....TTT..TT
T1TT.....................TTTTTTTTTTTTTTTTTTTTTTTTTTT9T...T.....TTT
TTTTTTTTTTTTTTTTTTTTTTTTTTTTTTTTTTTTTTTTTTTTTTTTTTTTTTTTTTTTTTTTTT
